Type,Product,Started Date,Completed Date,Description,Amount,Fee,Currency,State,Balance
TRANSFER,Current,2025-03-01 17:23:09,2025-03-01 17:23:09,To BGN,23.22,0.00,BGN,COMPLETED,23.22
TRANSFER,Current,2025-03-01 17:45:42,2025-03-01 17:45:42,To BGN,23.30,0.00,BGN,COMPLETED,46.52
CARD_PAYMENT,Current,2025-03-01 17:23:18,2025-03-03 15:04:47,Lidl,-23.22,0.00,BGN,COMPLETED,23.30
CARD_PAYMENT,Current,2025-03-01 17:45:50,2025-03-03 17:38:14,Kaufland,-23.30,0.00,BGN,COMPLETED,0.00
TRANSFER,Current,2025-03-04 07:31:52,2025-03-04 07:31:52,To BGN,20.00,0.00,BGN,COMPLETED,20.00
TRANSFER,Current,2025-03-04 07:32:07,2025-03-04 07:32:07,To BGN –ê–ø—Ä–∏–ª —Ö—Ä–∞–Ω–∞,-20.00,0.00,BGN,COMPLETED,0.00
TRANSFER,Current,2025-03-04 14:03:41,2025-03-04 14:03:41,To BGN,6.20,0.00,BGN,COMPLETED,6.20
TRANSFER,Current,2025-03-04 15:26:05,2025-03-04 15:26:05,To BGN,12.47,0.00,BGN,COMPLETED,18.67
TRANSFER,Current,2025-03-04 15:26:35,2025-03-04 15:26:35,To BGN,23.00,0.00,BGN,COMPLETED,41.67
TRANSFER,Current,2025-03-04 15:26:49,2025-03-04 15:26:49,To BGN,29.82,0.00,BGN,COMPLETED,71.49
TRANSFER,Current,2025-03-04 15:40:24,2025-03-04 15:40:24,To BGN –î–µ—Ü–∞ üë¶üèª üë∂üèª,-0.47,0.00,BGN,COMPLETED,71.02
CARD_PAYMENT,Current,2025-03-04 15:27:37,2025-03-05 07:37:50,Temu,-64.82,0.00,BGN,COMPLETED,6.20
CARD_PAYMENT,Current,2025-03-04 14:03:57,2025-03-05 14:45:47,Goldfingers,-6.20,0.00,BGN,COMPLETED,0.00
TRANSFER,Current,2025-03-05 17:44:07,2025-03-05 17:44:07,To BGN,19.66,0.00,BGN,COMPLETED,19.66
TRANSFER,Current,2025-03-05 17:57:16,2025-03-05 17:57:16,To BGN,15.00,0.00,BGN,COMPLETED,34.66
TRANSFER,Current,2025-03-06 08:40:54,2025-03-06 08:40:54,To BGN –ê–ø—Ä–∏–ª —Ö—Ä–∞–Ω–∞,-7.52,0.00,BGN,COMPLETED,27.14
TOPUP,Current,2025-03-06 08:41:18,2025-03-06 08:41:19,Apple Pay Top-Up by *1857,390.00,0.00,BGN,COMPLETED,417.14
TRANSFER,Current,2025-03-06 08:42:15,2025-03-06 08:42:15,To BGN –î–µ—Ü–∞ üë¶üèª üë∂üèª,-220.00,0.00,BGN,COMPLETED,197.14
TRANSFER,Current,2025-03-06 08:42:44,2025-03-06 08:42:44,To BGN –ú–∏—Å–∏,-30.00,0.00,BGN,COMPLETED,167.14
TRANSFER,Current,2025-03-06 08:43:00,2025-03-06 08:43:00,Transfer to Revolut user,-20.00,0.00,BGN,COMPLETED,147.14
TRANSFER,Current,2025-03-06 08:43:55,2025-03-06 08:43:55,To BGN –ö–æ–Ω—Å–µ—Ä–≤–∏—Ä–∞–Ω–µ/–∑–∏–º–Ω–∏–Ω–∞,-120.00,0.00,BGN,COMPLETED,27.14
TRANSFER,Current,2025-03-06 08:44:08,2025-03-06 08:44:08,To BGN,40.00,0.00,BGN,COMPLETED,67.14
TRANSFER,Current,2025-03-06 08:44:20,2025-03-06 08:44:20,To BGN –ô–æ–∏–ª –±–æ–ª–Ω–∏—Ü–∞,-20.00,0.00,BGN,COMPLETED,47.14
TRANSFER,Current,2025-03-06 08:44:35,2025-03-06 08:44:35,To BGN –†–æ–∂–¥–µ–Ω –¥–µ–Ω –ï–º–∞–Ω—É–∏–ª,-10.00,0.00,BGN,COMPLETED,37.14
TRANSFER,Current,2025-03-06 08:44:44,2025-03-06 08:44:44,To BGN –†–æ–∂–¥–µ–Ω –¥–µ–Ω –ô–æ–∏–ª,-10.00,0.00,BGN,COMPLETED,27.14
TRANSFER,Current,2025-03-06 08:45:02,2025-03-06 08:45:02,To BGN,10.00,0.00,BGN,COMPLETED,37.14
TRANSFER,Current,2025-03-06 08:45:15,2025-03-06 08:45:15,To BGN –¶–∞–π—Å –§–æ–Ω–¥,-10.00,0.00,BGN,COMPLETED,27.14
TRANSFER,Current,2025-03-06 08:45:32,2025-03-06 08:45:32,To BGN,5.00,0.00,BGN,COMPLETED,32.14
TRANSFER,Current,2025-03-06 08:45:44,2025-03-06 08:45:44,"To BGN –°—ä–¥–æ–º–∏—è–ª–Ω–∞ ",-5.00,0.00,BGN,COMPLETED,27.14
CARD_PAYMENT,Current,2025-03-05 17:44:16,2025-03-06 16:10:03,Lidl,-19.66,0.00,BGN,COMPLETED,7.48
CARD_PAYMENT,Current,2025-03-05 17:57:58,2025-03-06 17:44:49,Kaufland,-7.48,0.00,BGN,COMPLETED,0.00
TRANSFER,Current,2025-03-07 15:58:50,2025-03-07 15:58:50,To BGN,19.90,0.00,BGN,COMPLETED,19.90
TRANSFER,Current,2025-03-07 15:59:57,2025-03-07 15:59:57,To BGN,30.14,0.00,BGN,COMPLETED,50.04
TRANSFER,Current,2025-03-07 16:00:21,2025-03-07 16:00:21,To BGN –ê–ø—Ä–∏–ª —Ö—Ä–∞–Ω–∞,-19.90,0.00,BGN,COMPLETED,30.14
TRANSFER,Current,2025-03-07 16:20:33,2025-03-07 16:20:33,To BGN,4.50,0.00,BGN,COMPLETED,34.64
TRANSFER,Current,2025-03-07 20:55:07,2025-03-07 20:55:07,To BGN –ê–ø—Ä–∏–ª —Ö—Ä–∞–Ω–∞,-0.01,0.00,BGN,COMPLETED,34.63
TRANSFER,Current,2025-03-08 18:54:29,2025-03-08 18:54:29,To BGN,21.50,0.00,BGN,COMPLETED,56.13
TRANSFER,Current,2025-03-08 19:11:45,2025-03-08 19:11:45,To BGN,13.00,0.00,BGN,COMPLETED,69.13
TRANSFER,Current,2025-03-08 19:21:10,2025-03-08 19:21:10,To BGN,34.25,0.00,BGN,COMPLETED,103.38
TRANSFER,Current,2025-03-08 19:22:50,2025-03-08 19:22:50,To BGN,15.90,0.00,BGN,COMPLETED,119.28
TRANSFER,Current,2025-03-08 19:23:20,2025-03-08 19:23:20,To BGN,16.85,0.00,BGN,COMPLETED,136.13
TRANSFER,Current,2025-03-08 19:23:44,2025-03-08 19:23:44,To BGN –ê–ø—Ä–∏–ª —Ö—Ä–∞–Ω–∞,-32.75,0.00,BGN,COMPLETED,103.38
CARD_PAYMENT,Current,2025-03-08 18:54:42,2025-03-09 16:29:48,PEPCO,-21.50,0.00,BGN,COMPLETED,81.88
CARD_PAYMENT,Current,2025-03-08 19:11:58,2025-03-09 16:29:48,PEPCO,-13.00,0.00,BGN,COMPLETED,68.88
TRANSFER,Current,2025-03-09 18:59:45,2025-03-09 18:59:45,To BGN,5.55,0.00,BGN,COMPLETED,74.43
CARD_PAYMENT,Current,2025-03-09 18:59:54,2025-03-10 15:10:26,BILLA,-5.55,0.00,BGN,COMPLETED,68.88
CARD_PAYMENT,Current,2025-03-07 16:00:08,2025-03-10 15:10:28,BILLA,-30.14,0.00,BGN,COMPLETED,38.74
CARD_PAYMENT,Current,2025-03-08 19:21:22,2025-03-10 15:10:29,BILLA,-34.25,0.00,BGN,COMPLETED,4.49
CARD_PAYMENT,Current,2025-03-07 16:20:57,2025-03-10 15:11:05,Zoomania Megastore Plovdiv,-4.49,0.00,BGN,COMPLETED,0.00
TRANSFER,Current,2025-03-11 19:26:21,2025-03-11 19:26:21,To BGN,10.00,0.00,BGN,COMPLETED,10.00
CARD_PAYMENT,Current,2025-03-11 19:31:37,2025-03-12 16:19:25,Elmaz Tts Ood,-5.18,0.00,BGN,COMPLETED,4.82
TRANSFER,Current,2025-03-12 17:28:11,2025-03-12 17:28:11,To BGN,54.32,0.00,BGN,COMPLETED,59.14
TRANSFER,Current,2025-03-12 17:32:08,2025-03-12 17:32:08,To BGN –ê–ø—Ä–∏–ª —Ö—Ä–∞–Ω–∞,-4.82,0.00,BGN,COMPLETED,54.32
TRANSFER,Current,2025-03-12 17:32:24,2025-03-12 17:32:24,To BGN,40.00,0.00,BGN,COMPLETED,94.32
TRANSFER,Current,2025-03-12 17:33:11,2025-03-12 17:33:11,To BGN –ó–¥—Ä–∞–≤–µ ü©π,-29.50,0.00,BGN,COMPLETED,64.82
TRANSFER,Current,2025-03-12 17:59:51,2025-03-12 17:59:51,To BGN,14.14,0.00,BGN,COMPLETED,78.96
TRANSFER,Current,2025-03-12 18:17:57,2025-03-12 18:17:57,To BGN,10.21,0.00,BGN,COMPLETED,89.17
TRANSFER,Current,2025-03-12 21:34:00,2025-03-12 21:34:00,To BGN –ê–ø—Ä–∏–ª —Ö—Ä–∞–Ω–∞,-0.32,0.00,BGN,COMPLETED,88.85
TOPUP,Current,2025-03-13 09:21:19,2025-03-13 09:21:21,Apple Pay Top-Up by *1857,505.00,0.00,BGN,COMPLETED,593.85
TRANSFER,Current,2025-03-13 09:22:12,2025-03-13 09:22:12,Transfer to Revolut user,-390.00,0.00,BGN,COMPLETED,203.85
TRANSFER,Current,2025-03-13 09:22:34,2025-03-13 09:22:34,To BGN My,-30.00,0.00,BGN,COMPLETED,173.85
TRANSFER,Current,2025-03-13 09:22:51,2025-03-13 09:22:51,To BGN –î—Ä–µ—Ö–∏ üëóüëîü•æ,-30.00,0.00,BGN,COMPLETED,143.85
TRANSFER,Current,2025-03-13 09:29:11,2025-03-13 09:29:11,To BGN –ü–æ–¥–∞—Ä—ä—Ü–∏,-20.00,0.00,BGN,COMPLETED,123.85
TRANSFER,Current,2025-03-13 09:29:22,2025-03-13 09:29:22,Transfer to Revolut user,-15.00,0.00,BGN,COMPLETED,108.85
TRANSFER,Current,2025-03-13 09:29:35,2025-03-13 09:29:35,To BGN –ì–æ—Ä–∏–≤–æ Jogger,-15.00,0.00,BGN,COMPLETED,93.85
TRANSFER,Current,2025-03-13 09:29:46,2025-03-13 09:29:46,To BGN –ï–∫—Å—Ç—Ä–∞,-5.00,0.00,BGN,COMPLETED,88.85
TRANSFER,Current,2025-03-13 15:58:45,2025-03-13 15:58:45,To BGN,1.19,0.00,BGN,COMPLETED,90.04
CARD_PAYMENT,Current,2025-03-12 17:59:57,2025-03-13 16:30:48,Lidl,-14.14,0.00,BGN,COMPLETED,75.90
CARD_PAYMENT,Current,2025-03-12 17:32:54,2025-03-13 16:31:02,SOpharmacy,-10.18,0.00,BGN,COMPLETED,65.72
CARD_PAYMENT,Current,2025-03-12 18:18:02,2025-03-13 16:36:32,BILLA,-10.21,0.00,BGN,COMPLETED,55.51
CARD_PAYMENT,Current,2025-03-12 17:28:20,2025-03-13 18:24:15,Kaufland,-54.32,0.00,BGN,COMPLETED,1.19
CARD_PAYMENT,Current,2025-03-13 15:58:56,2025-03-14 19:00:44,Kaufland,-1.19,0.00,BGN,COMPLETED,0.00
TRANSFER,Current,2025-03-15 19:24:19,2025-03-15 19:24:19,To BGN,2.95,0.00,BGN,COMPLETED,2.95
TRANSFER,Current,2025-03-15 19:24:33,2025-03-15 19:24:33,To BGN,10.00,0.00,BGN,COMPLETED,12.95
TRANSFER,Current,2025-03-15 19:25:46,2025-03-15 19:25:46,To BGN,5.00,0.00,BGN,COMPLETED,17.95
TRANSFER,Current,2025-03-16 17:04:54,2025-03-16 17:04:55,Transfer from Revolut user,45.00,0.00,BGN,COMPLETED,62.95
TRANSFER,Current,2025-03-16 17:06:22,2025-03-16 17:06:22,To BGN My,-40.00,0.00,BGN,COMPLETED,22.95
TRANSFER,Current,2025-03-16 17:07:02,2025-03-16 17:07:02,To BGN –î–∞—Ä–µ–Ω–∏–µ BGN,-5.00,0.00,BGN,COMPLETED,17.95
TRANSFER,Current,2025-03-16 17:09:59,2025-03-16 17:09:59,To BGN –ê–ø—Ä–∏–ª —Ö—Ä–∞–Ω–∞,-4.04,0.00,BGN,COMPLETED,13.91
CARD_PAYMENT,Current,2025-03-15 19:27:09,2025-03-17 18:37:58,BILLA,-13.91,0.00,BGN,COMPLETED,0.00
TRANSFER,Current,2025-03-18 19:36:07,2025-03-18 19:36:07,To BGN,10.00,0.00,BGN,COMPLETED,10.00
TRANSFER,Current,2025-03-18 19:36:31,2025-03-18 19:36:31,To BGN,40.00,0.00,BGN,COMPLETED,50.00
TRANSFER,Current,2025-03-18 19:37:21,2025-03-18 19:37:22,Transfer to Revolut user,-50.00,0.00,BGN,COMPLETED,0.00
TRANSFER,Current,2025-03-18 19:58:53,2025-03-18 19:58:54,Transfer from Revolut user,20.00,0.00,BGN,COMPLETED,20.00
TRANSFER,Current,2025-03-18 21:29:36,2025-03-18 21:29:36,To BGN My,-20.00,0.00,BGN,COMPLETED,0.00
CARD_REFUND,Current,2025-03-17 23:47:39,2025-03-19 15:48:45,Temu,8.46,0.00,BGN,COMPLETED,8.46
TRANSFER,Current,2025-03-19 15:55:21,2025-03-19 15:55:21,To BGN My,-8.46,0.00,BGN,COMPLETED,0.00
TRANSFER,Current,2025-03-20 13:00:14,2025-03-20 13:00:14,Transfer from Revolut user,100.00,0.00,BGN,COMPLETED,100.00
TRANSFER,Current,2025-03-20 16:13:20,2025-03-20 16:13:20,To BGN –ú–∏–º–∏ –¥–µ–Ω –¥–µ–Ω,-100.00,0.00,BGN,COMPLETED,0.00
TRANSFER,Current,2025-03-20 16:14:03,2025-03-20 16:14:03,To BGN,3.00,0.00,BGN,COMPLETED,3.00
TRANSFER,Current,2025-03-20 16:14:26,2025-03-20 16:14:26,Transfer to Revolut user,-3.00,0.00,BGN,COMPLETED,0.00
TRANSFER,Current,2025-03-20 17:27:03,2025-03-20 17:27:03,To BGN,24.01,0.00,BGN,COMPLETED,24.01
TRANSFER,Current,2025-03-20 17:28:32,2025-03-20 17:28:32,To BGN,6.74,0.00,BGN,COMPLETED,30.75
TRANSFER,Current,2025-03-20 17:34:30,2025-03-20 17:34:30,To BGN,16.80,0.00,BGN,COMPLETED,47.55
TRANSFER,Current,2025-03-20 18:01:14,2025-03-20 18:01:14,To BGN,60.00,0.00,BGN,COMPLETED,107.55
TRANSFER,Current,2025-03-20 18:06:06,2025-03-20 18:06:06,To BGN –ê–ø—Ä–∏–ª —Ö—Ä–∞–Ω–∞,-24.30,0.00,BGN,COMPLETED,83.25
TRANSFER,Current,2025-03-20 18:06:43,2025-03-20 18:06:43,To BGN,16.47,0.00,BGN,COMPLETED,99.72
TRANSFER,Current,2025-03-20 18:07:08,2025-03-20 18:07:08,To BGN –ê–ø—Ä–∏–ª —Ö—Ä–∞–Ω–∞,-16.47,0.00,BGN,COMPLETED,83.25
TRANSFER,Current,2025-03-20 18:13:21,2025-03-20 18:13:21,To BGN,30.00,0.00,BGN,COMPLETED,113.25
TRANSFER,Current,2025-03-20 18:13:36,2025-03-20 18:13:36,To BGN –ì–æ—Ä–∏–≤–æ Jogger,-30.00,0.00,BGN,COMPLETED,83.25
TRANSFER,Current,2025-03-21 14:25:56,2025-03-21 14:25:56,To BGN,10.00,0.00,BGN,COMPLETED,93.25
TRANSFER,Current,2025-03-21 14:34:17,2025-03-21 14:34:17,To BGN –ê–ø—Ä–∏–ª —Ö—Ä–∞–Ω–∞,-3.40,0.00,BGN,COMPLETED,89.85
TRANSFER,Current,2025-03-21 14:34:28,2025-03-21 14:34:28,To BGN,5.00,0.00,BGN,COMPLETED,94.85
CARD_PAYMENT,Current,2025-03-20 18:02:16,2025-03-21 16:26:57,BILLA,-19.23,0.00,BGN,COMPLETED,75.62
CARD_PAYMENT,Current,2025-03-20 18:02:51,2025-03-21 16:26:59,BILLA,-16.47,0.00,BGN,COMPLETED,59.15
CARD_PAYMENT,Current,2025-03-20 17:34:42,2025-03-21 16:27:08,Plovdiv 3,-16.80,0.00,BGN,COMPLETED,42.35
CARD_PAYMENT,Current,2025-03-20 17:27:12,2025-03-21 18:19:53,Kaufland,-24.01,0.00,BGN,COMPLETED,18.34
CARD_PAYMENT,Current,2025-03-20 17:28:40,2025-03-21 18:19:53,Kaufland,-6.74,0.00,BGN,COMPLETED,11.60
TRANSFER,Current,2025-03-22 11:28:44,2025-03-22 11:28:44,To BGN,34.94,0.00,BGN,COMPLETED,46.54
TRANSFER,Current,2025-03-22 11:34:45,2025-03-22 11:34:45,To BGN,12.00,0.00,BGN,COMPLETED,58.54
TRANSFER,Current,2025-03-22 11:36:14,2025-03-22 11:36:14,To BGN,0.70,0.00,BGN,COMPLETED,59.24
CARD_PAYMENT,Current,2025-03-21 14:35:51,2025-03-22 16:03:24,PEPCO,-5.00,0.00,BGN,COMPLETED,54.24
TRANSFER,Current,2025-03-22 18:25:13,2025-03-22 18:25:13,To BGN,8.05,0.00,BGN,COMPLETED,62.29
TRANSFER,Current,2025-03-22 19:06:23,2025-03-22 19:06:24,Transfer from Revolut user,5.00,0.00,BGN,COMPLETED,67.29
TRANSFER,Current,2025-03-22 20:10:27,2025-03-22 20:10:27,To BGN,10.00,0.00,BGN,COMPLETED,77.29
TRANSFER,Current,2025-03-22 20:10:42,2025-03-22 20:10:42,To BGN –ê–ø—Ä–∏–ª —Ö—Ä–∞–Ω–∞,-15.00,0.00,BGN,COMPLETED,62.29
TRANSFER,Current,2025-03-22 20:10:52,2025-03-22 20:10:52,To BGN –ú–∏–º–∏ –¥–µ–Ω –¥–µ–Ω,-8.05,0.00,BGN,COMPLETED,54.24
CARD_PAYMENT,Current,2025-03-22 11:37:47,2025-03-23 10:28:51,PEPCO,-12.70,0.00,BGN,COMPLETED,41.54
TRANSFER,Current,2025-03-23 12:26:04,2025-03-23 12:26:04,To BGN,8.05,0.00,BGN,COMPLETED,49.59
TRANSFER,Current,2025-03-23 12:26:20,2025-03-23 12:26:21,Transfer to Revolut user,-8.05,0.00,BGN,COMPLETED,41.54
CARD_PAYMENT,Current,2025-03-21 14:27:11,2025-03-24 14:00:02,Plovdiv 3,-6.60,0.00,BGN,COMPLETED,34.94
CARD_PAYMENT,Current,2025-03-22 11:28:52,2025-03-24 17:49:10,KiK,-34.94,0.00,BGN,COMPLETED,0.00
TRANSFER,Current,2025-03-25 19:28:50,2025-03-25 19:28:50,To BGN,30.00,0.00,BGN,COMPLETED,30.00
ATM,Current,2025-03-25 19:29:19,2025-03-26 16:15:17,Cash at Ubbatm Shipka 6,-30.00,0.00,BGN,COMPLETED,0.00
TRANSFER,Current,2025-03-26 16:28:02,2025-03-26 16:28:02,To BGN,9.29,0.00,BGN,COMPLETED,9.29
TRANSFER,Current,2025-03-26 16:30:00,2025-03-26 16:30:00,To BGN,1.89,0.00,BGN,COMPLETED,11.18
TRANSFER,Current,2025-03-26 16:30:28,2025-03-26 16:30:28,To BGN –ê–ø—Ä–∏–ª —Ö—Ä–∞–Ω–∞,-1.89,0.00,BGN,COMPLETED,9.29
TRANSFER,Current,2025-03-26 16:46:52,2025-03-26 16:46:52,To BGN,12.00,0.00,BGN,COMPLETED,21.29
CARD_PAYMENT,Current,2025-03-26 16:28:08,2025-03-27 16:23:03,Lidl,-9.29,0.00,BGN,COMPLETED,12.00
TRANSFER,Current,2025-03-27 16:53:08,2025-03-27 16:53:08,To BGN,33.00,0.00,BGN,COMPLETED,45.00
TRANSFER,Current,2025-03-27 16:54:30,2025-03-27 16:54:30,To BGN –ö–æ–Ω—Å–µ—Ä–≤–∏—Ä–∞–Ω–µ/–∑–∏–º–Ω–∏–Ω–∞,-9.00,0.00,BGN,COMPLETED,36.00
TRANSFER,Current,2025-03-27 16:54:48,2025-03-27 16:54:48,To BGN,5.00,0.00,BGN,COMPLETED,41.00
TRANSFER,Current,2025-03-27 16:57:05,2025-03-27 16:57:05,To BGN,18.00,0.00,BGN,COMPLETED,59.00
TRANSFER,Current,2025-03-27 16:57:17,2025-03-27 16:57:17,To BGN,3.00,0.00,BGN,COMPLETED,62.00
CARD_PAYMENT,Current,2025-03-26 16:48:13,2025-03-27 18:41:59,Kaufland,-11.14,0.00,BGN,COMPLETED,50.86
CARD_PAYMENT,Current,2025-03-27 16:57:26,2025-03-28 17:02:19,Lidl,-49.03,0.00,BGN,COMPLETED,1.83
TRANSFER,Current,2025-03-29 09:47:51,2025-03-29 09:47:51,To BGN –ê–ø—Ä–∏–ª —Ö—Ä–∞–Ω–∞,-1.83,0.00,BGN,COMPLETED,0.00
TRANSFER,Current,2025-03-29 12:22:45,2025-03-29 12:22:45,To BGN,5.27,0.00,BGN,COMPLETED,5.27
TRANSFER,Current,2025-03-29 16:38:40,2025-03-29 16:38:40,To BGN,50.00,0.00,BGN,COMPLETED,55.27
TRANSFER,Current,2025-03-29 16:45:18,2025-03-29 16:45:18,To BGN,6.00,0.00,BGN,COMPLETED,61.27
TRANSFER,Current,2025-03-29 16:45:47,2025-03-29 16:45:47,To BGN,2.00,0.00,BGN,COMPLETED,63.27
TRANSFER,Current,2025-03-29 16:46:00,2025-03-29 16:46:00,To BGN –¶–∞–π—Å –§–æ–Ω–¥,-26.35,0.00,BGN,COMPLETED,36.92
TRANSFER,Current,2025-03-29 17:14:31,2025-03-29 17:14:31,To BGN,8.10,0.00,BGN,COMPLETED,45.02
TRANSFER,Current,2025-03-29 17:16:50,2025-03-29 17:16:50,To BGN,5.00,0.00,BGN,COMPLETED,50.02
TRANSFER,Current,2025-03-29 17:17:04,2025-03-29 17:17:04,To BGN,1.13,0.00,BGN,COMPLETED,51.15
TRANSFER,Current,2025-03-29 17:17:16,2025-03-29 17:17:16,To BGN –ö–æ–Ω—Å–µ—Ä–≤–∏—Ä–∞–Ω–µ/–∑–∏–º–Ω–∏–Ω–∞,-6.13,0.00,BGN,COMPLETED,45.02
TRANSFER,Current,2025-03-30 18:09:35,2025-03-30 18:09:35,To BGN,15.00,0.00,BGN,COMPLETED,60.02
TRANSFER,Current,2025-03-30 18:19:16,2025-03-30 18:19:16,To BGN –ö–æ–Ω—Å–µ—Ä–≤–∏—Ä–∞–Ω–µ/–∑–∏–º–Ω–∏–Ω–∞,-3.74,0.00,BGN,COMPLETED,56.28
TRANSFER,Current,2025-03-31 17:12:08,2025-03-31 17:12:08,To BGN,3.83,0.00,BGN,COMPLETED,60.11
CARD_PAYMENT,Current,2025-03-30 18:11:02,2025-03-31 17:14:17,Praktiker Plovdi,-11.26,0.00,BGN,COMPLETED,48.85
CARD_PAYMENT,Current,2025-03-29 17:14:41,2025-03-31 17:20:37,BILLA,-8.10,0.00,BGN,COMPLETED,40.75
CARD_PAYMENT,Current,2025-03-29 12:22:56,2025-03-31 17:20:39,BILLA,-5.27,0.00,BGN,COMPLETED,35.48
TRANSFER,Savings,2025-03-01 17:23:09,2025-03-01 17:23:09,To BGN,-23.22,0.00,BGN,COMPLETED,1011.65
TRANSFER,Savings,2025-03-01 17:45:42,2025-03-01 17:45:42,To BGN,-23.30,0.00,BGN,COMPLETED,988.35
TRANSFER,Savings,2025-03-04 07:31:52,2025-03-04 07:31:52,To BGN,-20.00,0.00,BGN,COMPLETED,968.35
TRANSFER,Savings,2025-03-04 07:32:07,2025-03-04 07:32:07,To BGN –ê–ø—Ä–∏–ª —Ö—Ä–∞–Ω–∞,20.00,0.00,BGN,COMPLETED,988.35
TRANSFER,Savings,2025-03-04 11:19:44,2025-03-04 11:19:45,Transfer from Revolut user,100.00,0.00,BGN,COMPLETED,1088.35
TRANSFER,Savings,2025-03-04 11:24:10,2025-03-04 11:24:11,Transfer from Revolut user,20.00,0.00,BGN,COMPLETED,1108.35
TRANSFER,Savings,2025-03-04 14:03:41,2025-03-04 14:03:41,To BGN,-6.20,0.00,BGN,COMPLETED,1102.15
TRANSFER,Savings,2025-03-04 15:26:05,2025-03-04 15:26:05,To BGN,-12.47,0.00,BGN,COMPLETED,1089.68
TRANSFER,Savings,2025-03-04 15:26:35,2025-03-04 15:26:35,To BGN,-23.00,0.00,BGN,COMPLETED,1066.68
TRANSFER,Savings,2025-03-04 15:26:49,2025-03-04 15:26:49,To BGN,-29.82,0.00,BGN,COMPLETED,1036.86
TRANSFER,Savings,2025-03-04 15:40:24,2025-03-04 15:40:24,To BGN –î–µ—Ü–∞ üë¶üèª üë∂üèª,0.47,0.00,BGN,COMPLETED,1037.33
TRANSFER,Savings,2025-03-05 17:44:07,2025-03-05 17:44:07,To BGN,-19.66,0.00,BGN,COMPLETED,1017.67
TRANSFER,Savings,2025-03-05 17:57:16,2025-03-05 17:57:16,To BGN,-15.00,0.00,BGN,COMPLETED,1002.67
TRANSFER,Savings,2025-03-06 08:40:54,2025-03-06 08:40:54,To BGN –ê–ø—Ä–∏–ª —Ö—Ä–∞–Ω–∞,7.52,0.00,BGN,COMPLETED,1010.19
TRANSFER,Savings,2025-03-06 08:42:15,2025-03-06 08:42:15,To BGN –î–µ—Ü–∞ üë¶üèª üë∂üèª,220.00,0.00,BGN,COMPLETED,1230.19
TRANSFER,Savings,2025-03-06 08:42:44,2025-03-06 08:42:44,To BGN –ú–∏—Å–∏,30.00,0.00,BGN,COMPLETED,1260.19
TRANSFER,Savings,2025-03-06 08:43:55,2025-03-06 08:43:55,To BGN –ö–æ–Ω—Å–µ—Ä–≤–∏—Ä–∞–Ω–µ/–∑–∏–º–Ω–∏–Ω–∞,120.00,0.00,BGN,COMPLETED,1380.19
TRANSFER,Savings,2025-03-06 08:44:08,2025-03-06 08:44:08,To BGN,-40.00,0.00,BGN,COMPLETED,1340.19
TRANSFER,Savings,2025-03-06 08:44:20,2025-03-06 08:44:20,To BGN –ô–æ–∏–ª –±–æ–ª–Ω–∏—Ü–∞,20.00,0.00,BGN,COMPLETED,1360.19
TRANSFER,Savings,2025-03-06 08:44:35,2025-03-06 08:44:35,To BGN –†–æ–∂–¥–µ–Ω –¥–µ–Ω –ï–º–∞–Ω—É–∏–ª,10.00,0.00,BGN,COMPLETED,1370.19
TRANSFER,Savings,2025-03-06 08:44:44,2025-03-06 08:44:44,To BGN –†–æ–∂–¥–µ–Ω –¥–µ–Ω –ô–æ–∏–ª,10.00,0.00,BGN,COMPLETED,1380.19
TRANSFER,Savings,2025-03-06 08:45:02,2025-03-06 08:45:02,To BGN,-10.00,0.00,BGN,COMPLETED,1370.19
TRANSFER,Savings,2025-03-06 08:45:15,2025-03-06 08:45:15,To BGN –¶–∞–π—Å –§–æ–Ω–¥,10.00,0.00,BGN,COMPLETED,1380.19
TRANSFER,Savings,2025-03-06 08:45:32,2025-03-06 08:45:32,To BGN,-5.00,0.00,BGN,COMPLETED,1375.19
TRANSFER,Savings,2025-03-06 08:45:44,2025-03-06 08:45:44,"To BGN –°—ä–¥–æ–º–∏—è–ª–Ω–∞ ",5.00,0.00,BGN,COMPLETED,1380.19
TRANSFER,Savings,2025-03-06 08:50:36,2025-03-06 08:50:36,Transfer to Revolut user,-55.00,0.00,BGN,COMPLETED,1325.19
TRANSFER,Savings,2025-03-06 09:07:16,2025-03-06 09:07:16,Transfer from Revolut user,12.00,0.00,BGN,COMPLETED,1337.19
TRANSFER,Savings,2025-03-07 15:58:50,2025-03-07 15:58:50,To BGN,-19.90,0.00,BGN,COMPLETED,1317.29
TRANSFER,Savings,2025-03-07 15:59:57,2025-03-07 15:59:57,To BGN,-30.14,0.00,BGN,COMPLETED,1287.15
TRANSFER,Savings,2025-03-07 16:00:21,2025-03-07 16:00:21,To BGN –ê–ø—Ä–∏–ª —Ö—Ä–∞–Ω–∞,19.90,0.00,BGN,COMPLETED,1307.05
TRANSFER,Savings,2025-03-07 16:20:33,2025-03-07 16:20:33,To BGN,-4.50,0.00,BGN,COMPLETED,1302.55
TRANSFER,Savings,2025-03-07 20:55:07,2025-03-07 20:55:07,To BGN –ê–ø—Ä–∏–ª —Ö—Ä–∞–Ω–∞,0.01,0.00,BGN,COMPLETED,1302.56
TRANSFER,Savings,2025-03-07 23:35:49,2025-03-07 23:35:49,Transfer to Revolut user,-20.00,0.00,BGN,COMPLETED,1282.56
TRANSFER,Savings,2025-03-08 18:54:29,2025-03-08 18:54:29,To BGN,-21.50,0.00,BGN,COMPLETED,1261.06
TRANSFER,Savings,2025-03-08 19:11:45,2025-03-08 19:11:45,To BGN,-13.00,0.00,BGN,COMPLETED,1248.06
TRANSFER,Savings,2025-03-08 19:21:10,2025-03-08 19:21:10,To BGN,-34.25,0.00,BGN,COMPLETED,1213.81
TRANSFER,Savings,2025-03-08 19:22:50,2025-03-08 19:22:50,To BGN,-15.90,0.00,BGN,COMPLETED,1197.91
TRANSFER,Savings,2025-03-08 19:23:20,2025-03-08 19:23:20,To BGN,-16.85,0.00,BGN,COMPLETED,1181.06
TRANSFER,Savings,2025-03-08 19:23:44,2025-03-08 19:23:44,To BGN –ê–ø—Ä–∏–ª —Ö—Ä–∞–Ω–∞,32.75,0.00,BGN,COMPLETED,1213.81
TRANSFER,Savings,2025-03-09 18:58:06,2025-03-09 18:58:06,Transfer to Revolut user,-24.42,0.00,BGN,COMPLETED,1189.39
TRANSFER,Savings,2025-03-09 18:59:45,2025-03-09 18:59:45,To BGN,-5.55,0.00,BGN,COMPLETED,1183.84
TRANSFER,Savings,2025-03-10 07:49:44,2025-03-10 07:49:45,Transfer from Revolut user,10.00,0.00,BGN,COMPLETED,1193.84
TRANSFER,Savings,2025-03-10 12:38:03,2025-03-10 12:38:04,Transfer to Revolut user,-10.00,0.00,BGN,COMPLETED,1183.84
TRANSFER,Savings,2025-03-10 12:38:47,2025-03-10 12:38:47,Transfer to Revolut user,-9.00,0.00,BGN,COMPLETED,1174.84
TRANSFER,Savings,2025-03-10 12:38:57,2025-03-10 12:38:57,Transfer from Revolut user,10.00,0.00,BGN,COMPLETED,1184.84
TRANSFER,Savings,2025-03-10 15:06:57,2025-03-10 15:06:58,Transfer to Revolut user,-10.00,0.00,BGN,COMPLETED,1174.84
TRANSFER,Savings,2025-03-11 19:26:21,2025-03-11 19:26:21,To BGN,-10.00,0.00,BGN,COMPLETED,1164.84
TRANSFER,Savings,2025-03-12 17:28:11,2025-03-12 17:28:11,To BGN,-54.32,0.00,BGN,COMPLETED,1110.52
TRANSFER,Savings,2025-03-12 17:32:08,2025-03-12 17:32:08,To BGN –ê–ø—Ä–∏–ª —Ö—Ä–∞–Ω–∞,4.82,0.00,BGN,COMPLETED,1115.34
TRANSFER,Savings,2025-03-12 17:32:24,2025-03-12 17:32:24,To BGN,-40.00,0.00,BGN,COMPLETED,1075.34
TRANSFER,Savings,2025-03-12 17:33:11,2025-03-12 17:33:11,To BGN –ó–¥—Ä–∞–≤–µ ü©π,29.50,0.00,BGN,COMPLETED,1104.84
TRANSFER,Savings,2025-03-12 17:59:51,2025-03-12 17:59:51,To BGN,-14.14,0.00,BGN,COMPLETED,1090.70
TRANSFER,Savings,2025-03-12 18:17:57,2025-03-12 18:17:57,To BGN,-10.21,0.00,BGN,COMPLETED,1080.49
TRANSFER,Savings,2025-03-12 21:34:00,2025-03-12 21:34:00,To BGN –ê–ø—Ä–∏–ª —Ö—Ä–∞–Ω–∞,0.32,0.00,BGN,COMPLETED,1080.81
TRANSFER,Savings,2025-03-13 09:01:05,2025-03-13 09:01:05,Transfer to Revolut user,-188.91,0.00,BGN,COMPLETED,891.90
TRANSFER,Savings,2025-03-13 09:22:34,2025-03-13 09:22:34,To BGN My,30.00,0.00,BGN,COMPLETED,921.90
TRANSFER,Savings,2025-03-13 09:22:51,2025-03-13 09:22:51,To BGN –î—Ä–µ—Ö–∏ üëóüëîü•æ,30.00,0.00,BGN,COMPLETED,951.90
TRANSFER,Savings,2025-03-13 09:29:11,2025-03-13 09:29:11,To BGN –ü–æ–¥–∞—Ä—ä—Ü–∏,20.00,0.00,BGN,COMPLETED,971.90
TRANSFER,Savings,2025-03-13 09:29:35,2025-03-13 09:29:35,To BGN –ì–æ—Ä–∏–≤–æ Jogger,15.00,0.00,BGN,COMPLETED,986.90
TRANSFER,Savings,2025-03-13 09:29:46,2025-03-13 09:29:46,To BGN –ï–∫—Å—Ç—Ä–∞,5.00,0.00,BGN,COMPLETED,991.90
TRANSFER,Savings,2025-03-13 15:58:45,2025-03-13 15:58:45,To BGN,-1.19,0.00,BGN,COMPLETED,990.71
TRANSFER,Savings,2025-03-15 19:24:19,2025-03-15 19:24:19,To BGN,-2.95,0.00,BGN,COMPLETED,987.76
TRANSFER,Savings,2025-03-15 19:24:33,2025-03-15 19:24:33,To BGN,-10.00,0.00,BGN,COMPLETED,977.76
TRANSFER,Savings,2025-03-15 19:25:46,2025-03-15 19:25:46,To BGN,-5.00,0.00,BGN,COMPLETED,972.76
TRANSFER,Savings,2025-03-16 17:06:22,2025-03-16 17:06:22,To BGN My,40.00,0.00,BGN,COMPLETED,1012.76
TRANSFER,Savings,2025-03-16 17:07:02,2025-03-16 17:07:02,To BGN –î–∞—Ä–µ–Ω–∏–µ BGN,5.00,0.00,BGN,COMPLETED,1017.76
TRANSFER,Savings,2025-03-16 17:09:59,2025-03-16 17:09:59,To BGN –ê–ø—Ä–∏–ª —Ö—Ä–∞–Ω–∞,4.04,0.00,BGN,COMPLETED,1021.80
TRANSFER,Savings,2025-03-17 17:14:04,2025-03-17 17:14:07,Transfer to Revolut user,-5.00,0.00,BGN,COMPLETED,1016.80
TRANSFER,Savings,2025-03-18 16:10:33,2025-03-18 16:10:33,Transfer to Revolut user,-50.00,0.00,BGN,COMPLETED,966.80
TRANSFER,Savings,2025-03-18 19:36:07,2025-03-18 19:36:07,To BGN,-10.00,0.00,BGN,COMPLETED,956.80
TRANSFER,Savings,2025-03-18 19:36:31,2025-03-18 19:36:31,To BGN,-40.00,0.00,BGN,COMPLETED,916.80
TRANSFER,Savings,2025-03-18 21:29:36,2025-03-18 21:29:36,To BGN My,20.00,0.00,BGN,COMPLETED,936.80
TRANSFER,Savings,2025-03-19 15:55:21,2025-03-19 15:55:21,To BGN My,8.46,0.00,BGN,COMPLETED,945.26
TRANSFER,Savings,2025-03-19 17:53:42,2025-03-19 17:53:42,Transfer to Revolut user,-10.00,0.00,BGN,COMPLETED,935.26
TRANSFER,Savings,2025-03-19 21:10:01,2025-03-19 21:10:01,Transfer from Revolut user,2.00,0.00,BGN,COMPLETED,937.26
TRANSFER,Savings,2025-03-20 16:13:20,2025-03-20 16:13:20,To BGN –ú–∏–º–∏ –¥–µ–Ω –¥–µ–Ω,100.00,0.00,BGN,COMPLETED,1037.26
TRANSFER,Savings,2025-03-20 16:14:03,2025-03-20 16:14:03,To BGN,-3.00,0.00,BGN,COMPLETED,1034.26
TRANSFER,Savings,2025-03-20 17:27:03,2025-03-20 17:27:03,To BGN,-24.01,0.00,BGN,COMPLETED,1010.25
TRANSFER,Savings,2025-03-20 17:28:32,2025-03-20 17:28:32,To BGN,-6.74,0.00,BGN,COMPLETED,1003.51
TRANSFER,Savings,2025-03-20 17:34:30,2025-03-20 17:34:30,To BGN,-16.80,0.00,BGN,COMPLETED,986.71
TRANSFER,Savings,2025-03-20 18:01:14,2025-03-20 18:01:14,To BGN,-60.00,0.00,BGN,COMPLETED,926.71
TRANSFER,Savings,2025-03-20 18:06:06,2025-03-20 18:06:06,To BGN –ê–ø—Ä–∏–ª —Ö—Ä–∞–Ω–∞,24.30,0.00,BGN,COMPLETED,951.01
TRANSFER,Savings,2025-03-20 18:06:43,2025-03-20 18:06:43,To BGN,-16.47,0.00,BGN,COMPLETED,934.54
TRANSFER,Savings,2025-03-20 18:07:08,2025-03-20 18:07:08,To BGN –ê–ø—Ä–∏–ª —Ö—Ä–∞–Ω–∞,16.47,0.00,BGN,COMPLETED,951.01
TRANSFER,Savings,2025-03-20 18:13:21,2025-03-20 18:13:21,To BGN,-30.00,0.00,BGN,COMPLETED,921.01
TRANSFER,Savings,2025-03-20 18:13:36,2025-03-20 18:13:36,To BGN –ì–æ—Ä–∏–≤–æ Jogger,30.00,0.00,BGN,COMPLETED,951.01
TRANSFER,Savings,2025-03-21 09:02:32,2025-03-21 09:02:32,Transfer to Revolut user,-50.00,0.00,BGN,COMPLETED,901.01
TRANSFER,Savings,2025-03-21 09:27:37,2025-03-21 09:27:38,Transfer from Revolut user,6.00,0.00,BGN,COMPLETED,907.01
TRANSFER,Savings,2025-03-21 14:25:56,2025-03-21 14:25:56,To BGN,-10.00,0.00,BGN,COMPLETED,897.01
TRANSFER,Savings,2025-03-21 14:34:17,2025-03-21 14:34:17,To BGN –ê–ø—Ä–∏–ª —Ö—Ä–∞–Ω–∞,3.40,0.00,BGN,COMPLETED,900.41
TRANSFER,Savings,2025-03-21 14:34:28,2025-03-21 14:34:28,To BGN,-5.00,0.00,BGN,COMPLETED,895.41
TRANSFER,Savings,2025-03-21 15:51:14,2025-03-21 15:51:15,Transfer to Revolut user,-20.00,0.00,BGN,COMPLETED,875.41
TRANSFER,Savings,2025-03-22 11:28:44,2025-03-22 11:28:44,To BGN,-34.94,0.00,BGN,COMPLETED,840.47
TRANSFER,Savings,2025-03-22 11:34:45,2025-03-22 11:34:45,To BGN,-12.00,0.00,BGN,COMPLETED,828.47
TRANSFER,Savings,2025-03-22 11:36:14,2025-03-22 11:36:14,To BGN,-0.70,0.00,BGN,COMPLETED,827.77
TRANSFER,Savings,2025-03-22 18:25:13,2025-03-22 18:25:13,To BGN,-8.05,0.00,BGN,COMPLETED,819.72
TRANSFER,Savings,2025-03-22 19:06:02,2025-03-22 19:06:02,Transfer to Revolut user,-5.00,0.00,BGN,COMPLETED,814.72
TRANSFER,Savings,2025-03-22 20:10:27,2025-03-22 20:10:27,To BGN,-10.00,0.00,BGN,COMPLETED,804.72
TRANSFER,Savings,2025-03-22 20:10:42,2025-03-22 20:10:42,To BGN –ê–ø—Ä–∏–ª —Ö—Ä–∞–Ω–∞,15.00,0.00,BGN,COMPLETED,819.72
TRANSFER,Savings,2025-03-22 20:10:52,2025-03-22 20:10:52,To BGN –ú–∏–º–∏ –¥–µ–Ω –¥–µ–Ω,8.05,0.00,BGN,COMPLETED,827.77
TRANSFER,Savings,2025-03-23 12:26:04,2025-03-23 12:26:04,To BGN,-8.05,0.00,BGN,COMPLETED,819.72
TRANSFER,Savings,2025-03-25 19:28:50,2025-03-25 19:28:50,To BGN,-30.00,0.00,BGN,COMPLETED,789.72
TRANSFER,Savings,2025-03-26 12:17:46,2025-03-26 12:17:46,Transfer to Revolut user,-12.00,0.00,BGN,COMPLETED,777.72
TRANSFER,Savings,2025-03-26 16:28:02,2025-03-26 16:28:02,To BGN,-9.29,0.00,BGN,COMPLETED,768.43
TRANSFER,Savings,2025-03-26 16:30:00,2025-03-26 16:30:00,To BGN,-1.89,0.00,BGN,COMPLETED,766.54
TRANSFER,Savings,2025-03-26 16:30:28,2025-03-26 16:30:28,To BGN –ê–ø—Ä–∏–ª —Ö—Ä–∞–Ω–∞,1.89,0.00,BGN,COMPLETED,768.43
TRANSFER,Savings,2025-03-26 16:46:52,2025-03-26 16:46:52,To BGN,-12.00,0.00,BGN,COMPLETED,756.43
TRANSFER,Savings,2025-03-27 08:46:10,2025-03-27 08:46:11,Transfer to Revolut user,-40.00,0.00,BGN,COMPLETED,716.43
TRANSFER,Savings,2025-03-27 16:53:08,2025-03-27 16:53:08,To BGN,-33.00,0.00,BGN,COMPLETED,683.43
TRANSFER,Savings,2025-03-27 16:54:30,2025-03-27 16:54:30,To BGN –ö–æ–Ω—Å–µ—Ä–≤–∏—Ä–∞–Ω–µ/–∑–∏–º–Ω–∏–Ω–∞,9.00,0.00,BGN,COMPLETED,692.43
TRANSFER,Savings,2025-03-27 16:54:48,2025-03-27 16:54:48,To BGN,-5.00,0.00,BGN,COMPLETED,687.43
TRANSFER,Savings,2025-03-27 16:57:05,2025-03-27 16:57:05,To BGN,-18.00,0.00,BGN,COMPLETED,669.43
TRANSFER,Savings,2025-03-27 16:57:17,2025-03-27 16:57:17,To BGN,-3.00,0.00,BGN,COMPLETED,666.43
TRANSFER,Savings,2025-03-29 09:47:51,2025-03-29 09:47:51,To BGN –ê–ø—Ä–∏–ª —Ö—Ä–∞–Ω–∞,1.83,0.00,BGN,COMPLETED,668.26
TRANSFER,Savings,2025-03-29 12:22:45,2025-03-29 12:22:45,To BGN,-5.27,0.00,BGN,COMPLETED,662.99
TRANSFER,Savings,2025-03-29 16:38:40,2025-03-29 16:38:40,To BGN,-50.00,0.00,BGN,COMPLETED,612.99
TRANSFER,Savings,2025-03-29 16:45:18,2025-03-29 16:45:18,To BGN,-6.00,0.00,BGN,COMPLETED,606.99
TRANSFER,Savings,2025-03-29 16:45:47,2025-03-29 16:45:47,To BGN,-2.00,0.00,BGN,COMPLETED,604.99
TRANSFER,Savings,2025-03-29 16:46:00,2025-03-29 16:46:00,To BGN –¶–∞–π—Å –§–æ–Ω–¥,26.35,0.00,BGN,COMPLETED,631.34
TRANSFER,Savings,2025-03-29 17:14:31,2025-03-29 17:14:31,To BGN,-8.10,0.00,BGN,COMPLETED,623.24
TRANSFER,Savings,2025-03-29 17:16:50,2025-03-29 17:16:50,To BGN,-5.00,0.00,BGN,COMPLETED,618.24
TRANSFER,Savings,2025-03-29 17:17:04,2025-03-29 17:17:04,To BGN,-1.13,0.00,BGN,COMPLETED,617.11
TRANSFER,Savings,2025-03-29 17:17:16,2025-03-29 17:17:16,To BGN –ö–æ–Ω—Å–µ—Ä–≤–∏—Ä–∞–Ω–µ/–∑–∏–º–Ω–∏–Ω–∞,6.13,0.00,BGN,COMPLETED,623.24
TRANSFER,Savings,2025-03-30 18:09:35,2025-03-30 18:09:35,To BGN,-15.00,0.00,BGN,COMPLETED,608.24
TRANSFER,Savings,2025-03-30 18:19:16,2025-03-30 18:19:16,To BGN –ö–æ–Ω—Å–µ—Ä–≤–∏—Ä–∞–Ω–µ/–∑–∏–º–Ω–∏–Ω–∞,3.74,0.00,BGN,COMPLETED,611.98
TRANSFER,Savings,2025-03-30 18:54:45,2025-03-30 18:54:47,Transfer from Revolut user,20.00,0.00,BGN,COMPLETED,631.98
TRANSFER,Savings,2025-03-31 17:12:08,2025-03-31 17:12:08,To BGN,-3.83,0.00,BGN,COMPLETED,628.15
